W , W , W , W , W , W , W , W , W , W , W , W , W , W , W , W , W , W , W , W
W ,   ,   ,   ,   , W ,   ,   ,   ,   ,   ,   ,   ,   ,   ,   ,   ,   ,   , W
W ,   ,   ,   ,   ,   ,   ,   ,   ,   ,   ,   ,   ,   ,   ,   ,   ,   ,   , W
W ,   , W ,   ,   ,   ,   ,   ,   ,   ,   ,   ,   ,   ,   ,   ,   ,   ,   , W
W ,   ,   ,   ,   , F ,   ,   ,   ,   ,   ,   ,   ,   ,   ,   ,   ,   ,   , W
W ,   ,   ,   ,   ,   ,   ,   ,   ,   ,   ,   ,   ,   ,   ,   ,   ,   ,   , W
W ,   ,   ,   ,   ,   ,   ,   ,   ,   ,   ,   ,   ,   , K2,   ,   ,   ,   , W
W ,   , P ,   ,   ,   ,   ,   ,   ,   ,   ,   ,   ,   ,   ,   ,   ,   ,   , W
W ,   ,   ,   ,   ,   ,   , M ,   ,   ,   ,   ,   ,   ,   ,   ,   ,   ,   , W
W , W , W , W , W , W , 1 , W , W , W , W , W , W , W , W , W , W , W , W , W