W,W,W,W,W,W,W,W,W,W,W,W,W,W,W,W,W,W,W,W
0,0,0,0,0,0,0,0,0,P,0,0,0,0,0,0,0,0,A,W
W,W,0,W,0,0,0,0,0,W,0,0,0,0,0,0,0,0,0,W
W,0,0,0,B,0,0,0,0,W,0,0,0,0,0,0,0,0,0,W
W,W,W,0,0,0,0,V,0,W,0,0,0,0,0,W,0,0,0,W
W,W,0,W,0,0,0,0,A,0,0,0,0,0,0,0,0,0,0,W
W,W,0,0,W,0,0,0,0,0,0,0,0,0,0,0,0,0,0,W
W,W,0,W,0,0,0,W,0,0,0,0,0,0,0,0,0,0,0,W
W,W,W,0,0,0,0,0,0,L,W,W,W,W,0,0,L,0,C,W
W,W,W,W,W,W,W,W,W,W,W,W,W,W,W,W,W,W,W,W