W,W,W,W,W,W,W,W,W,W,W,W,W,W,W,W,W,W,W,W
W,0,0,0,0,0,0,0,0,0,0,0,0,0,0,0,0,0,0,W
W,0,B,0,0,0,0,0,0,0,0,0,0,0,0,0,0,0,0,W
W,0,0,0,0,0,0,0,0,V,W,V,0,0,0,0,0,0,0,W
W,0,0,0,0,0,0,0,0,W,K,W,0,0,0,0,0,0,0,W
W,0,0,0,0,0,0,0,0,W,K,W,0,0,0,0,0,0,0,W
W,0,0,0,0,0,0,0,0,V,W,V,0,0,0,0,0,0,0,W
W,0,0,0,0,0,0,0,0,0,0,0,0,0,0,0,0,0,0,W
W,0,0,0,0,0,0,0,0,0,0,0,0,0,0,0,0,0,0,W
W,W,0,W,W,W,W,W,W,W,W,W,W,W,W,W,W,W,W,W